Hello World. You wake up, but something doesn't feel right. You quickly get out of bed. Where is everyone? You should probably check the time.

Adventure
An Interactive Fiction by Hansen Wu
Release 1 / Serial number 161129 / Inform 7 build 6M62 (I6/v6.33 lib 6/12N) SD

Home
It's gray and dull in here. Bright sunlight pours in through the window.

You can see a watch, a laptop and a charger here.

>n
You can't go that way.

>w
You can't go that way.

>a
That's not a verb I recognise.

* * *

Hello World. You wake up, but something doesn't feel right. You quickly get out of bed. Where is everyone? You should probably check the time.

Adventure
An Interactive Fiction by Hansen Wu
Release 1 / Serial number 161129 / Inform 7 build 6M62 (I6/v6.33 lib 6/12N) SD

Home
It's gray and dull in here. Bright sunlight pours in through the window.

You can see a watch, a laptop and a charger here.

>l
Examined
something
You feel unprepared. Did you forget something?

>x
What do you want to examine?

* * *

>l
Examined
something
You feel unprepared. Did you forget something?

>l w
You see nothing unexpected in that direction.

>l n
You see nothing unexpected in that direction.

>w
SJSU
A college in Silicon Valley with historical roots, stuck in the middle of downtown San Jose.

>climb
What do you want to climb?

>descend
You can't see any such thing.

>down
You can't go that way.

>up
You can't go that way.

>east
Landing
It's gray and dull in here, but brightly lit. Where is everyone?

* * *

>l
Examined
something
You feel unprepared. Did you forget something?

>t
That's not a verb I recognise.

>help
That's not a verb I recognise.

>w
You can't go that way.

>s
Dining Room
The humans are all in the next room.  You smell some tasty food from on top of the table. 

The table is too high for you to see on top, but you can smell treats!

It is a wide chair.  Uncle Carl usually sits there

>e
You can't go that way.

>n
kitchen
It is bright and shiny in here.  Your owner loves to make tasty treats in here.  Several of the humans are here.

Turkey!  It is like giant chicken!  Surely the humans will not mind if you take a small taste…

Uncle Carl is a nice man.  Sometimes he has a treat.

Momlady is a nice person.  She makes food.

Aunt Judy never has treats.  What more needs to be said?

>z
Time passes.

Momlady moves the turkey from the kitchen to the table in the dining room.

>s
Dining Room
The humans are all in the next room.  You smell some tasty food from on top of the table. Something tasty is on the table, you are sure of it.

Turkey!  It is like giant chicken!  Surely the humans will not mind if you take a small taste…

The table is too high for you to see on top, but you can smell treats!

It is a wide chair.  Uncle Carl usually sits there

>go to kitchen
You can't see any such thing.

>Go to Kitchen
You can't see any such thing.

>l n
You see nothing unexpected in that direction.

>l
Dining Room
The humans are all in the next room.  You smell some tasty food from on top of the table. Something tasty is on the table, you are sure of it.

Turkey!  It is like giant chicken!  Surely the humans will not mind if you take a small taste…

The table is too high for you to see on top, but you can smell treats!

It is a wide chair.  Uncle Carl usually sits there

>e chair
I only understood you as far as wanting to (go) e.

>l chair
You see nothing special about the chair.

>l turkey
You see nothing special about the turkey.

>l fdsa
You can't see any such thing.

>l table
You see nothing special about the table.

>e
You can't go that way.

>l
Dining Room
The humans are all in the next room.  You smell some tasty food from on top of the table. Something tasty is on the table, you are sure of it.

Turkey!  It is like giant chicken!  Surely the humans will not mind if you take a small taste…

The table is too high for you to see on top, but you can smell treats!

It is a wide chair.  Uncle Carl usually sits there

>ex
That's not a verb I recognise.

>eat turkey
You take a small little bite.  It is good!  You eat more.  One of the little humans comes into the room.  "Rex! Bad dog!  Mom, Rex is eating the turkey!"
You have been a BAD DOG.  You hang your head in shame and climb down the chair to the floor, still chewing Turkey.  One of the big humans comes in with a broom.  "Bad dog! Outside.

    *** It is cold out here!  And all of the humans are inside without you!  Life is unfair….  Hey, a squirrel!!! ***

Would you like to RESTART, RESTORE a saved game, QUIT or UNDO the last command?

>restart
Your name is Rex, the family dog.  Today is a special day!  Many people are here today visiting your humans.  And there are many tasty treats and good smells!  Hmm…  How can you get something to eat?

Turkey Quest
An Interactive Fiction by Thomas H. Austin
Release 1 / Serial number 161121 / Inform 7 build 6M62 (I6/v6.33 lib 6/12N) SD

kitchen
It is bright and shiny in here.  Your owner loves to make tasty treats in here.  Several of the humans are here.

Turkey!  It is like giant chicken!  Surely the humans will not mind if you take a small taste…

Uncle Carl is a nice man.  Sometimes he has a treat.

Momlady is a nice person.  She makes food.

Aunt Judy never has treats.  What more needs to be said?

>eat turkey
You move towards the turkey, but one of the humans says "bad Rex!" and slaps you on the nose.  You slink away, knowing that you were a BAD DOG.

>z
Time passes.

>l
kitchen
It is bright and shiny in here.  Your owner loves to make tasty treats in here.  Several of the humans are here.

Turkey!  It is like giant chicken!  Surely the humans will not mind if you take a small taste…

Uncle Carl is a nice man.  Sometimes he has a treat.

Momlady is a nice person.  She makes food.

Aunt Judy never has treats.  What more needs to be said?

>z
Time passes.

>z
Time passes.

>z
Time passes.

Momlady moves the turkey from the kitchen to the table in the dining room.

* * *

>s
Dining Room
The humans are all in the next room.  You smell some tasty food from on top of the table. Something tasty is on the table, you are sure of it.

Turkey!  It is like giant chicken!  Surely the humans will not mind if you take a small taste…

The table is too high for you to see on top, but you can smell treats!

It is a wide chair.  Uncle Carl usually sits there

>e carl
I only understood you as far as wanting to (go) e.

>ex garl
That's not a verb I recognise.

>ex carl
That's not a verb I recognise.

>examine carl
You can't see any such thing.

>examine uncle carl
You can't see any such thing.

>n
kitchen
It is bright and shiny in here.  Your owner loves to make tasty treats in here.  Several of the humans are here.

Uncle Carl is a nice man.  Sometimes he has a treat.

Momlady is a nice person.  She makes food.

Aunt Judy never has treats.  What more needs to be said?

>ex Momlady
That's not a verb I recognise.

>examine Momlady
You see nothing special about Momlady.

>examine Uncle carl
He looks over at you and smiles.  "I did'nt forget about you boy.  Here, have this."  He drops a chewtoy.

>l
kitchen
It is bright and shiny in here.  Your owner loves to make tasty treats in here.  Several of the humans are here.

It looks like a little hamburger

Uncle Carl is a nice man.  Sometimes he has a treat.

Momlady is a nice person.  She makes food.

Aunt Judy never has treats.  What more needs to be said?

>examine chewtoy
You see nothing special about the chewtoy.

>eat chewtoy
>>>SQUEAK<<<  Hmm, maybe that is not food.

>s
Dining Room
The humans are all in the next room.  You smell some tasty food from on top of the table. Something tasty is on the table, you are sure of it.

Turkey!  It is like giant chicken!  Surely the humans will not mind if you take a small taste…

The table is too high for you to see on top, but you can smell treats!

It is a wide chair.  Uncle Carl usually sits there

>take chewtoy
You can't see any such thing.

>n
kitchen
It is bright and shiny in here.  Your owner loves to make tasty treats in here.  Several of the humans are here.

It looks like a little hamburger

Uncle Carl is a nice man.  Sometimes he has a treat.

Momlady is a nice person.  She makes food.

Aunt Judy never has treats.  What more needs to be said?

>take chewtoy
Taken.

>i
You are carrying:
  a chewtoy

>travel
That's not a verb I recognise.

>i
You are carrying:
  a chewtoy

>eat chewtoy
>>>SQUEAK<<<  Hmm, maybe that is not food.

* * *

>s
Dining Room
The humans are all in the next room.  You smell some tasty food from on top of the table. Something tasty is on the table, you are sure of it.

Turkey!  It is like giant chicken!  Surely the humans will not mind if you take a small taste…

The table is too high for you to see on top, but you can smell treats!

It is a wide chair.  Uncle Carl usually sits there

>eat chewtoy
>>>SQUEAK<<<  Hmm, maybe that is not food.

>ex chewtoy
That's not a verb I recognise.

>examine chewtoy
You see nothing special about the chewtoy.

>look chewtoy
You see nothing special about the chewtoy.

>eat table
That's plainly inedible.

>take table
Taken.

>i
You are carrying:
  a table
  a chewtoy

>l
Dining Room
The humans are all in the next room.  You smell some tasty food from on top of the table. Something tasty is on the table, you are sure of it.

Turkey!  It is like giant chicken!  Surely the humans will not mind if you take a small taste…

It is a wide chair.  Uncle Carl usually sits there

>take turkey
Taken.

>i
You are carrying:
  a turkey
  a table
  a chewtoy

>n
kitchen
It is bright and shiny in here.  Your owner loves to make tasty treats in here.  Several of the humans are here.

Uncle Carl is a nice man.  Sometimes he has a treat.

Momlady is a nice person.  She makes food.

Aunt Judy never has treats.  What more needs to be said?

>eat turkey
You move towards the turkey, but one of the humans says "bad Rex!" and slaps you on the nose.  You slink away, knowing that you were a BAD DOG.

>s
Dining Room
The humans are all in the next room.  You smell some tasty food from on top of the table. 

It is a wide chair.  Uncle Carl usually sits there

>eat turkey
You take a small little bite.  It is good!  You eat more.  One of the little humans comes into the room.  "Rex! Bad dog!  Mom, Rex is eating the turkey!"
You have been a BAD DOG.  You hang your head in shame and climb down the chair to the floor, still chewing Turkey.  One of the big humans comes in with a broom.  "Bad dog! Outside.

    *** It is cold out here!  And all of the humans are inside without you!  Life is unfair….  Hey, a squirrel!!! ***

Would you like to RESTART, RESTORE a saved game, QUIT or UNDO the last command?

* * *

>l
Examined
something
You feel unprepared. Did you forget something?

>w
SJSU
You arrive at school, dodging potholes, debris, and terrible drivers on the road. The sun's already up and people are out and about. You lock your bike in the bike cage and quickly head to MacQuarrie Hall. This is SJSU, a college in Silicon Valley with a long history, stuck in the middle of downtown San Jose. You should go to the CS Club and get some work done before class starts.

The staircase leads up to the clubroom on the second floor.

You feel unprepared.

>l
SJSU
A college in Silicon Valley with historical roots, stuck in the middle of downtown San Jose.

No time for that!

* * *

>w
SJSU
You arrive at school, dodging potholes, debris, and terrible drivers on the road. The sun's already up and people are out and about. You lock your bike in the bike cage and quickly head to MacQuarrie Hall. This is SJSU, a college in Silicon Valley with a long history, stuck in the middle of downtown San Jose. You should go to the CS Club and get some work done before class starts.

The staircase leads up to the clubroom on the second floor.

You feel unprepared.

>i
You are carrying nothing.

You feel unprepared.

>l
SJSU
A college in Silicon Valley with historical roots, stuck in the middle of downtown San Jose.

You feel unprepared.

* * *

>w
SJSU
You arrive at school, dodging potholes, debris, and terrible drivers on the road. The sun's already up and people are out and about. You lock your bike in the bike cage and quickly head to MacQuarrie Hall. This is SJSU, a college in Silicon Valley with a long history, stuck in the middle of downtown San Jose. You should go to the CS Club and get some work done before class starts.

The staircase leads up to the clubroom on the second floor.

You feel unprepared.

>Examine watch
You woke up far too late! Good thing there's still time to get to school. Speaking of which, school is to the west
You feel a lack of grasp on the time. Where's your watch?
Your backpack feels unusually light.
Something doesn't feel right.

>w
You can't go to school.

You feel a lack of grasp on the time. Where's your watch?
Your backpack feels unusually light.
Something doesn't feel right.

* * *

>w
SJSU
You arrive at school, dodging potholes, debris, and terrible drivers on the road. The sun's already up and people are out and about. You lock your bike in the bike cage and quickly head to MacQuarrie Hall. This is SJSU, a college in Silicon Valley with a long history, stuck in the middle of downtown San Jose. You should go to the CS Club and get some work done before class starts.

The staircase leads up to the clubroom on the second floor.

You feel unprepared.

>climb staircase
(first opening the staircase)

Clubroom
The staircase leads to the first floor and the rest of SJSU.

You feel unprepared.

>climb staircase
SJSU
SJSU, a college in Silicon Valley with a long history, stuck in the middle of downtown San Jose. You should go to the CS Club and get some work done before class starts.

The staircase leads up to the clubroom on the second floor.

what is the time
You feel unprepared.

* * *

>climb staircase
(first opening the staircase)

Clubroom
The staircase leads to the first floor and the rest of SJSU.

You feel unprepared.

>l
Clubroom
The staircase leads to the first floor and the rest of SJSU.

You feel unprepared.

* * *

>l
Examined
something
You feel unprepared. Did you forget something?

>go weset
You can't see any such thing.

>go west
SJSU
You arrive at school!A college in Silicon Valley with historical roots, stuck in the middle of downtown San Jose.

>go east
Home
It's gray and dull in here. Bright sunlight pours in through the window.

You can see a watch, a laptop and a charger here.

You feel a lack of grasp on the time. Where's your watch?
Your backpack feels unusually light.
Something doesn't feel right.

>go SJSU
You can't see any such thing.

>go to west
You can't see any such thing.

>visit sjsu
That's not a verb I recognise.

>visit
That's not a verb I recognise.

>go north
You can't go that way.

You feel a lack of grasp on the time. Where's your watch?
Your backpack feels unusually light.
Something doesn't feel right.

>w
SJSU
A college in Silicon Valley with historical roots, stuck in the middle of downtown San Jose.

* * *

>l
Examined
something
You feel unprepared. Did you forget something?

>examine watch
You woke up far too late! Good thing there's still time to get to school. Speaking of which, school is to the west.

You feel a lack of grasp on the time. Where's your watch?
Your backpack feels unusually light.
Something doesn't feel right.

>l
Home
It's gray and dull in here. Bright sunlight pours in through the window. You should check the time.

You can see a watch, a laptop and a charger here.

You feel a lack of grasp on the time. Where's your watch?
Your backpack feels unusually light.
Something doesn't feel right.

* * *

Hello World. You wake up, but something doesn't feel right. You quickly get out of bed. Where is everyone? You should probably check the time.

Adventure
An Interactive Fiction by Hansen Wu
Release 1 / Serial number 161129 / Inform 7 build 6M62 (I6/v6.33 lib 6/12N) SD

Home
It's gray and dull in here. Bright sunlight pours in through the window.

You can see a watch, a laptop and a charger here.

>i
You are carrying nothing.

You feel a lack of grasp on the time. Where's your watch?

>l
Landing
It's gray and dull in here. Bright sunlight pours in through the window. Where is everyone?

You can see a watch, a laptop and a laptop charger here.

You feel a lack of grasp on the time. Where's your watch?

>k
That's not a verb I recognise.

>o
Sorry, that can't be corrected.

>e
You can't go that way.

>r
That's not a verb I recognise.

>t
That's not a verb I recognise.

>q
Are you sure you want to quit?

* * *

>k
That's not a verb I recognise.

>j
That's not a verb I recognise.

>g
That's not a verb I recognise.

>h
That's not a verb I recognise.

>c
That's not a verb I recognise.

>z
Time passes.

>l
Landing
It's gray and dull in here, but brightly lit. Where is everyone?

>go
You'll have to say which compass direction to go in.

>go w
You can't go that way.

>go n
You can't go that way.

>go to sjsu
You can't see any such thing.

* * *

>l
Landing
It's gray and dull in here. Bright sunlight pours in through the window. Where is everyone?

You can see a watch, a laptop and a laptop charger here.

You feel a lack of grasp on the time. Where's your watch?

>examine watch
You woke up far too late! Good thing there's still time to get to school.

You feel a lack of grasp on the time. Where's your watch?

>take watch
Taken.

>i
You are carrying:
  a watch

* * *

Hello World. You wake up, but something doesn't feel right. You quickly get out of bed. Where is everyone? You should probably check the time.

Adventure
An Interactive Fiction by Hansen Wu
Release 1 / Serial number 161129 / Inform 7 build 6M62 (I6/v6.33 lib 6/12N) SD

Home
It's gray and dull in here. Bright sunlight pours in through the window.

You can see a watch, a laptop and a charger here.

>go to sjsu
You can't see any such thing.

>go to SJSU
You can't see any such thing.

>g sjsu
You can't see any such thing.

* * *

>go to sjsu
You can't see any such thing.

>go to landing
You can't see any such thing.

>go to Landing
You can't see any such thing.

* * *

Hello World. You wake up, but something doesn't feel right. You quickly get out of bed. Where is everyone? You should probably check the time.

Adventure
An Interactive Fiction by Hansen Wu
Release 1 / Serial number 161129 / Inform 7 build 6M62 (I6/v6.33 lib 6/12N) SD

Home
It's gray and dull in here. Bright sunlight pours in through the window.

You can see a watch, a laptop and a charger here.

>go to stateroom
You can't see any such thing.

* * *

Hello World. You wake up, but something doesn't feel right. You quickly get out of bed. Where is everyone? You should probably check the time.

Adventure
An Interactive Fiction by Hansen Wu
Release 1 / Serial number 161129 / Inform 7 build 6M62 (I6/v6.33 lib 6/12N) SD

Home
It's gray and dull in here. Bright sunlight pours in through the window.

You can see a watch, a laptop and a charger here.

>g
You can hardly repeat that.

>goto
That's not a verb I recognise.

>go to Landing
You can't see any such thing.

>w
SJSU

* * *

Hello World. You wake up, but something doesn't feel right. You quickly get out of bed. Where is everyone? You should probably check the time.

Adventure
An Interactive Fiction by Hansen Wu
Release 1 / Serial number 161129 / Inform 7 build 6M62 (I6/v6.33 lib 6/12N) SD

Home
It's gray and dull in here. Bright sunlight pours in through the window.

You can see a watch, a laptop and a charger here.

>west
Shouldn't you get oriented first?

You feel a lack of grasp on the time. Where's your watch?
Your backpack feels unusually light.
Something doesn't feel right.

>l
Landing
It's gray and dull in here, but brightly lit. Where is everyone?

>look
Landing
It's gray and dull in here, but brightly lit. Where is everyone?

* * *

Hello World. You wake up, but something doesn't feel right. You quickly get out of bed. Where is everyone? You should probably check the time.

Adventure
An Interactive Fiction by Hansen Wu
Release 1 / Serial number 161129 / Inform 7 build 6M62 (I6/v6.33 lib 6/12N) SD

Home
It's gray and dull in here. Bright sunlight pours in through the window.

You can see a watch, a laptop and a charger here.

>see west
That's not a verb I recognise.

>look west
You see nothing unexpected in that direction.

>west
You finally arrive at school, albeit quite later than you hoped for.

>look
Landing
It's gray and dull in here, but brightly lit. Where is everyone?

>west
You finally arrive at school, albeit quite later than you hoped for.

* * *

Hello World. You wake up, but something doesn't feel right. You quickly get out of bed. Where is everyone? You should probably check the time.

Adventure
An Interactive Fiction by Hansen Wu
Release 1 / Serial number 161129 / Inform 7 build 6M62 (I6/v6.33 lib 6/12N) SD

Home
It's gray and dull in here. Bright sunlight pours in through the window.

You can see a watch, a laptop and a charger here.

>walk to SJSU
You can't see any such thing.

* * *

Hello World. You wake up, but something doesn't feel right. You quickly get out of bed. Where is everyone? You should probably check the time.

Adventure
An Interactive Fiction by Hansen Wu
Release 1 / Serial number 161129 / Inform 7 build 6M62 (I6/v6.33 lib 6/12N) SD

Home
It's gray and dull in here. Bright sunlight pours in through the window.

You can see a watch, a laptop and a charger here.

>examine laptop
Your laptop is lying around. Ten pounds of Linux! This is where the Cyber happens. 

You feel a lack of grasp on the time. Where's your watch?
Your backpack feels unusually light.
Something doesn't feel right.

>examine the laptop
Which do you mean, the laptop or the laptop charger?

>examine the laptop.
Which do you mean, the laptop or the laptop charger?

>"examine the laptop"
You can't see any such thing.

>examine the laptop.
Which do you mean, the laptop or the laptop charger?

>examine the laptop charger
Your laptop charger is lying around. Don't forget to take it with you!

You feel a lack of grasp on the time. Where's your watch?

Your backpack feels unusually light.

Something doesn't feel right.

* * *

>examine laptop
Your laptop is lying around. Ten pounds of Linux! This is where the Cyber happens. 

You feel a lack of grasp on the time. Where's your watch?
Your backpack feels unusually light.
Something doesn't feel right.

>enter Landing
You can't see any such thing.

>enter laptop
That's not something you can enter.

You feel a lack of grasp on the time. Where's your watch?
Your backpack feels unusually light.
Something doesn't feel right.

>time
That's not a verb I recognise.

>t
That's not a verb I recognise.

>w
You finally arrive at school, albeit quite later than you hoped for.

You feel a lack of grasp on the time. Where's your watch?
Your backpack feels unusually light.
Something doesn't feel right.

>l
Landing
It's gray and dull in here. Bright sunlight pours in through the window.

You can see a watch, a laptop and a charger here.

You feel a lack of grasp on the time. Where's your watch?
Your backpack feels unusually light.
Something doesn't feel right.

* * *

>examine laptop
Your laptop is lying around. Ten pounds of Linux! This is where the Cyber happens. 

You feel a lack of grasp on the time. Where's your watch?
Your backpack feels unusually light.
Something doesn't feel right.

>w
SJSU
You arrive at school, dodging potholes, debris, and terrible drivers on the road. The sun's already up and people are out and about. You lock your bike in the bike cage and quickly head to MacQuarrie Hall. This is SJSU, a college in Silicon Valley with a long history, stuck in the middle of downtown San Jose.

You feel unprepared.

>Examine laptop
You can't see any such thing.

* * *

>examine laptop
Your laptop is lying around. Ten pounds of Linux! This is where the Cyber happens. 

You feel a lack of grasp on the time. Where's your watch?
Your backpack feels unusually light.
Something doesn't feel right.

>examine charger
Your laptop charger is lying around. Don't forget to take it with you!

You feel a lack of grasp on the time. Where's your watch?
Your backpack feels unusually light.
Something doesn't feel right.

>examine watch
You woke up far too late! Good thing there's still time to get to school. Speaking of which, school is to the west.

You feel a lack of grasp on the time. Where's your watch?
Your backpack feels unusually light.
Something doesn't feel right.

* * *

>examine laptop
Your laptop is lying around. Ten pounds of Linux! This is where the Cyber happens. 

You feel a lack of grasp on the time. Where's your watch?
Your backpack feels unusually light.
Something doesn't feel right.

>take laptop and charger
laptop: Taken.
charger: Taken.

You feel a lack of grasp on the time. Where's your watch?

>w
SJSU
You arrive at school, dodging potholes, debris, and terrible drivers on the road. The sun's already up and people are out and about. You lock your bike in the bike cage and quickly head to MacQuarrie Hall. This is SJSU, a college in Silicon Valley with a long history, stuck in the middle of downtown San Jose. You should go to the CS Club and get some work done before class starts.

The staircase leads up to the clubroom on the second floor.

>u
(first opening the staircase)

Clubroom
This is the CS club room. CS stuff happens here. Strange, where is everyone?

The staircase leads to the first floor and the rest of SJSU.

>drop laptop
Dropped.

You feel unprepared.

Alright, let's get cracking! You open up your laptop and get started, going through the boot sequence and typing in passwords.
You plug in your laptop to charge it up. But what's this? The clubroom's door slams shut, and metal shielding covers the windows. The room goes dark, sirens blare, and red lights flash. It's the Cyber Room!

Cyber Room
The room is dark, there's flashing lights, and fast tempo electronica. Is this Def Con? A sign above the door says "Cyber Room". Evidently, the cyber happens here. A big red button appears beside you.

You can see Button here.

* * *

>examine laptop
Your laptop is lying around. Ten pounds of Linux! This is where the Cyber happens. 

You feel a lack of grasp on the time. Where's your watch?
Your backpack feels unusually light.
Something doesn't feel right.

>take laptop
Taken.

You feel a lack of grasp on the time. Where's your watch?
Something doesn't feel right.

>examine laptop
Ten pounds of Linux! This is where the Cyber happens. 

You feel a lack of grasp on the time. Where's your watch?
Something doesn't feel right.

* * *

Hello World. You wake up, but something doesn't feel right. You quickly get out of bed. Where is everyone? You should probably check the time.

Adventure
An Interactive Fiction by Hansen Wu
Release 1 / Serial number 161129 / Inform 7 build 6M62 (I6/v6.33 lib 6/12N) SD

Home
It's gray and dull in here. Bright sunlight pours in through the window.

You can see a watch, a laptop and a charger here.

>w
SJSU
You arrive at school, dodging potholes, debris, and terrible drivers on the road. The sun's already up and people are out and about. You lock your bike in the bike cage and quickly head to MacQuarrie Hall. This is SJSU, a college in Silicon Valley with a long history, stuck in the middle of downtown San Jose. You should go to the CS Club and get some work done before class starts.

The staircase leads up to the clubroom on the second floor.

You feel unprepared.

>l
Home
It's gray and dull in here. Bright sunlight pours in through the window.

You can see a watch, a laptop and a charger here.

You feel a lack of grasp on the time. Where's your watch?
Your backpack feels unusually light.
Something doesn't feel right.

>climb
What do you want to climb?

>i
You are carrying nothing.

>l
SJSU
A college in Silicon Valley with historical roots, stuck in the middle of downtown San Jose.

>e
No time for that!

* * *

>l
Home
It's gray and dull in here. Bright sunlight pours in through the window.

You can see a watch, a laptop and a charger here.

You feel a lack of grasp on the time. Where's your watch?
Your backpack feels unusually light.
Something doesn't feel right.

>examine watch
You check your watch. Oh no, you woke up far too late! Good thing there's still time to get to school. Speaking of which, school is to the west.

You feel a lack of grasp on the time. Where's your watch?
Your backpack feels unusually light.
Something doesn't feel right.

>w
Why would you go to school?... Wait, what time is it? You should check your watch first.

You feel a lack of grasp on the time. Where's your watch?
Your backpack feels unusually light.
Something doesn't feel right.

>w
Why would you go to school?... Wait, what time is it? You should check your watch first.

You feel a lack of grasp on the time. Where's your watch?
Your backpack feels unusually light.
Something doesn't feel right.

>examined watch
That's not a verb I recognise.

>examine watch
You check your watch. Oh no, you woke up far too late! Good thing there's still time to get to school. Speaking of which, school is to the west.

You feel a lack of grasp on the time. Where's your watch?
Your backpack feels unusually light.
Something doesn't feel right.

* * *

>w
SJSU
You arrive at school, dodging potholes, debris, and terrible drivers on the road. The sun's already up and people are out and about. You lock your bike in the bike cage and quickly head to MacQuarrie Hall. This is SJSU, a college in Silicon Valley with a long history, stuck in the middle of downtown San Jose. You should go to the CS Club and get some work done before class starts.

The staircase leads up to the clubroom on the second floor.

You feel unprepared.

>e
You can't go home, there's so much to get done!

You feel unprepared.

>w
You can't go that way.

You feel unprepared.

* * *

>w
SJSU
You arrive at school, dodging potholes, debris, and terrible drivers on the road. The sun's already up and people are out and about. You lock your bike in the bike cage and quickly head to MacQuarrie Hall. This is SJSU, a college in Silicon Valley with a long history, stuck in the middle of downtown San Jose. You should go to the CS Club and get some work done before class starts.

The staircase leads up to the clubroom on the second floor.

You feel unprepared.

>examine watch
You check your watch. Oh no, you woke up far too late! Good thing there's still time to get to school. Speaking of which, school is to the west.

You feel a lack of grasp on the time. Where's your watch?
Your backpack feels unusually light.
Something doesn't feel right.

>w
Why would you go to school right now?... Wait, what time is it? You should check your watch first.

You feel a lack of grasp on the time. Where's your watch?
Your backpack feels unusually light.
Something doesn't feel right.

>w
You can't go to school.

You feel a lack of grasp on the time. Where's your watch?
Your backpack feels unusually light.
Something doesn't feel right.

* * *

>examine watch
You check your watch. Oh no, you woke up far too late! Good thing there's still time to get to school. Speaking of which, school is to the west.

You feel a lack of grasp on the time. Where's your watch?
Your backpack feels unusually light.
Something doesn't feel right.

>take watch, laptop, charger
watch: Taken.
laptop: Taken.
charger: Taken.

>w
Why would you go to school right now?... Wait, what time is it? You should check your watch first.

>u
You can't go that way.

>look
Home
It's gray and dull in here. Bright sunlight pours in through the window.

>examine watch
You check your watch. Oh no, you woke up far too late! Good thing there's still time to get to school. Speaking of which, school is to the west.

>w
Why would you go to school right now?... Wait, what time is it? You should check your watch first.

* * *

>w
SJSU
You arrive at school, dodging potholes, debris, and terrible drivers on the road. The sun's already up and people are out and about. You lock your bike in the bike cage and quickly head to MacQuarrie Hall. This is SJSU, a college in Silicon Valley with a long history, stuck in the middle of downtown San Jose. You should go to the CS Club and get some work done before class starts.

The staircase leads up to the clubroom on the second floor.

You feel unprepared.

>take watch
Taken.

Your backpack feels unusually light.
Something doesn't feel right.

>w
You can't go to school.

Your backpack feels unusually light.
Something doesn't feel right.

>examine watch
You woke up far too late! Good thing there's still time to get to school. Speaking of which, school is to the west.

Your backpack feels unusually light.
Something doesn't feel right.

* * *

>w
SJSU
You arrive at school, dodging potholes, debris, and terrible drivers on the road. The sun's already up and people are out and about. You lock your bike in the bike cage and quickly head to MacQuarrie Hall. This is SJSU, a college in Silicon Valley with a long history, stuck in the middle of downtown San Jose. You should go to the CS Club and get some work done before class starts.

The staircase leads up to the clubroom on the second floor.

You feel unprepared.

>climb MQH Staircase
Little is to be achieved by that.

You feel unprepared.

* * *

>w
SJSU
You arrive at school, dodging potholes, debris, and terrible drivers on the road. The sun's already up and people are out and about. You lock your bike in the bike cage and quickly head to MacQuarrie Hall. This is SJSU, a college in Silicon Valley with a long history, stuck in the middle of downtown San Jose. You should go to the CS Club and get some work done before class starts.

The staircase leads up to the clubroom on the second floor.

You feel unprepared.

>climb staircase
Little is to be achieved by that.

You feel unprepared.

>enter staircase
(first opening the staircase)

Clubroom
The staircase leads up to the second floor.

You feel unprepared.

* * *

>w
SJSU
You arrive at school, dodging potholes, debris, and terrible drivers on the road. The sun's already up and people are out and about. You lock your bike in the bike cage and quickly head to MacQuarrie Hall. This is SJSU, a college in Silicon Valley with a long history, stuck in the middle of downtown San Jose. You should go to the CS Club and get some work done before class starts.

The staircase leads up to the clubroom on the second floor.

You feel unprepared.

>examine w
You see nothing unexpected in that direction.

You feel a lack of grasp on the time. Where's your watch?
Your backpack feels unusually light.
Something doesn't feel right.

>examine watch
You check your watch. Oh no, you woke up far too late! Good thing there's still time to get to school. Speaking of which, school is to the west.

You feel a lack of grasp on the time. Where's your watch?
Your backpack feels unusually light.
Something doesn't feel right.

* * *

>w
SJSU
You arrive at school, dodging potholes, debris, and terrible drivers on the road. The sun's already up and people are out and about. You lock your bike in the bike cage and quickly head to MacQuarrie Hall. This is SJSU, a college in Silicon Valley with a long history, stuck in the middle of downtown San Jose. You should go to the CS Club and get some work done before class starts.

The staircase leads up to the clubroom on the second floor.

You feel unprepared.

>climb stairs
You can't see any such thing.

>climb staircase
(first opening the staircase)

Clubroom
The staircase leads to the first floor and the rest of SJSU.

You feel unprepared.

>exit
But you aren't in anything at the moment.

You feel unprepared.

* * *

>w
SJSU
You arrive at school, dodging potholes, debris, and terrible drivers on the road. The sun's already up and people are out and about. You lock your bike in the bike cage and quickly head to MacQuarrie Hall. This is SJSU, a college in Silicon Valley with a long history, stuck in the middle of downtown San Jose. You should go to the CS Club and get some work done before class starts.

The staircase leads up to the clubroom on the second floor.

You feel unprepared.

>n
You can't go that way.

You feel unprepared.

>stairs
That's not a verb I recognise.

>climb stairs
You can't see any such thing.

>climb staircase
(first opening the staircase)

Clubroom
This is the CS club room. CS stuff happens here.

The staircase leads to the first floor and the rest of SJSU.

You feel unprepared.

You're in the clubroom

>climb stairs
You can't see any such thing.

* * *

>w
SJSU
You arrive at school, dodging potholes, debris, and terrible drivers on the road. The sun's already up and people are out and about. You lock your bike in the bike cage and quickly head to MacQuarrie Hall. This is SJSU, a college in Silicon Valley with a long history, stuck in the middle of downtown San Jose. You should go to the CS Club and get some work done before class starts.

The staircase leads up to the clubroom on the second floor.

You feel unprepared.

>up
(first opening the staircase)

Clubroom
This is the CS club room. CS stuff happens here. Strange, where is everyone?

The staircase leads to the first floor and the rest of SJSU.

You feel unprepared.

    *** A sinking feeling washes over you. Where's your laptop?! Unfortunately you can't get anything done today. ***

Would you like to RESTART, RESTORE a saved game, QUIT or UNDO the last command?

>item
That's not a verb I recognise.

>i
You are carrying nothing.

You feel unprepared.

You're in the clubroom

* * *

>w
SJSU
You arrive at school, dodging potholes, debris, and terrible drivers on the road. The sun's already up and people are out and about. You lock your bike in the bike cage and quickly head to MacQuarrie Hall. This is SJSU, a college in Silicon Valley with a long history, stuck in the middle of downtown San Jose. You should go to the CS Club and get some work done before class starts.

The staircase leads up to the clubroom on the second floor.

You feel unprepared.

>u
(first opening the staircase)

Clubroom
This is the CS club room. CS stuff happens here. You should take out your laptop and get working. Strange, where is everyone?

The staircase leads to the first floor and the rest of SJSU.

    *** A sinking feeling washes over you. Where's your laptop?! Unfortunately you can't get anything done today. ***

Would you like to RESTART, RESTORE a saved game, QUIT or UNDO the last command?

>quit
[ The game has finished ]

* * *

>u
(first opening the staircase)

Clubroom
This is the CS club room. CS stuff happens here. You should take out your laptop and get working. Strange, where is everyone?

The staircase leads to the first floor and the rest of SJSU.

    *** A sinking feeling washes over you. Where's your laptop?! Unfortunately you can't get anything done today. ***

Would you like to RESTART, RESTORE a saved game, QUIT or UNDO the last command?

>restart
Hello World. You wake up, but something doesn't feel right. You quickly get out of bed. Where is everyone? You should probably check the time.

Adventure
An Interactive Fiction by Ray Ting
Release 1 / Serial number 161128 / Inform 7 build 6M62 (I6/v6.33 lib 6/12N) SD

Home
It's gray and dull in here. Bright sunlight pours in through the window.

You can see a watch, a laptop and a charger here.

>take watch laptop charger
I only understood you as far as wanting to take the watch.

>take watch, laptop, charger
watch: Taken.
laptop: Taken.
charger: Taken.

>w
SJSU
You arrive at school, dodging potholes, debris, and terrible drivers on the road. The sun's already up and people are out and about. You lock your bike in the bike cage and quickly head to MacQuarrie Hall. This is SJSU, a college in Silicon Valley with a long history, stuck in the middle of downtown San Jose. You should go to the CS Club and get some work done before class starts.

The staircase leads up to the clubroom on the second floor.

>e
You can't go home, there's so much to get done!

>w
You can't go that way.

>u
(first opening the staircase)

Clubroom
This is the CS club room. CS stuff happens here. Strange, where is everyone? Oh well, put down your laptop and get working!

The staircase leads to the first floor and the rest of SJSU.

* * *

>w
SJSU
You arrive at school, dodging potholes, debris, and terrible drivers on the road. The sun's already up and people are out and about. You lock your bike in the bike cage and quickly head to MacQuarrie Hall. This is SJSU, a college in Silicon Valley with a long history, stuck in the middle of downtown San Jose. You should go to the CS Club and get some work done before class starts.

The staircase leads up to the clubroom on the second floor.

>u
(first opening the staircase)

Clubroom
This is the CS club room. CS stuff happens here. Strange, where is everyone? Oh well, put down your laptop and get working!

The staircase leads to the first floor and the rest of SJSU.

>drop laptop
Dropped.

You feel unprepared. Did you forget something?

Alright, let's get cracking! You open up your laptop and get started, going through the boot sequence and typing in passwords.

    *** success ***

Would you like to RESTART, RESTORE a saved game, QUIT or UNDO the last command?

* * *

>restart
Hello World. You wake up, but something doesn't feel right. You quickly get out of bed. Where is everyone? You should probably check the time.

Adventure
An Interactive Fiction by Ray Ting
Release 1 / Serial number 161128 / Inform 7 build 6M62 (I6/v6.33 lib 6/12N) SD

Home
It's gray and dull in here. Bright sunlight pours in through the window.

You can see a watch, a laptop and a charger here.

>take laptop and charger
laptop: Taken.
charger: Taken.

You feel a lack of grasp on the time. Where's your watch?

>w
SJSU
You arrive at school, dodging potholes, debris, and terrible drivers on the road. The sun's already up and people are out and about. You lock your bike in the bike cage and quickly head to MacQuarrie Hall. This is SJSU, a college in Silicon Valley with a long history, stuck in the middle of downtown San Jose. You should go to the CS Club and get some work done before class starts.

The staircase leads up to the clubroom on the second floor.

You feel unprepared.

>u
(first opening the staircase)

Clubroom
This is the CS club room. CS stuff happens here. Strange, where is everyone?

The staircase leads to the first floor and the rest of SJSU.

You feel unprepared.

* * *

Hello World. You wake up, but something doesn't feel right. You quickly get out of bed. Where is everyone? You should probably check the time.

Adventure
An Interactive Fiction by Hansen Wu
Release 1 / Serial number 161129 / Inform 7 build 6M62 (I6/v6.33 lib 6/12N) SD

Home
It's gray and dull in here. Bright sunlight pours in through the window.

You can see a watch, a laptop and a charger here.

>take watch, laptop
watch: Taken.
laptop: Taken.

Something doesn't feel right.

>take charger
Taken.

>w
SJSU
You arrive at school, dodging potholes, debris, and terrible drivers on the road. The sun's already up and people are out and about. You lock your bike in the bike cage and quickly head to MacQuarrie Hall. This is SJSU, a college in Silicon Valley with a long history, stuck in the middle of downtown San Jose.

>l
SJSU
SJSU, a college in Silicon Valley with a long history, stuck in the middle of downtown San Jose.

>i
You are carrying:
  a charger
  a laptop
  a watch

>examine charger
Your laptop charger is lying around. Don't forget to take it with you!

* * *

Hello World. You wake up, but something doesn't feel right. You quickly get out of bed. Where is everyone? You should probably check the time.

Adventure
An Interactive Fiction by Hansen Wu
Release 1 / Serial number 161129 / Inform 7 build 6M62 (I6/v6.33 lib 6/12N) SD

Home
It's gray and dull in here. Bright sunlight pours in through the window.

You can see a watch, a laptop and a charger here.

>e laptop
I only understood you as far as wanting to (go) e.

>ex laptop
That's not a verb I recognise.

>examine laptop
Your laptop is lying around. Ten pounds of Linux! This is where the Cyber happens.

You feel a lack of grasp on the time. Where's your watch?
Your backpack feels unusually light.
Something doesn't feel right.

>take laptop
Taken.

You feel a lack of grasp on the time. Where's your watch?
Something doesn't feel right.

>w
SJSU
You arrive at school, dodging potholes, debris, and terrible drivers on the road. The sun's already up and people are out and about. You lock your bike in the bike cage and quickly head to MacQuarrie Hall. This is SJSU, a college in Silicon Valley with a long history, stuck in the middle of downtown San Jose.

You feel unprepared.

>examine laptop
Ten pounds of Linux!

You feel unprepared.

* * *

Hello World. You wake up, but something doesn't feel right. You quickly get out of bed. Where is everyone? You should probably check the time.

Adventure
An Interactive Fiction by Hansen Wu
Release 1 / Serial number 161129 / Inform 7 build 6M62 (I6/v6.33 lib 6/12N) SD

Home
It's gray and dull in here. Bright sunlight pours in through the window.

You can see a watch, a laptop and a charger here.

>aware
That's not a verb I recognise.

* * *

Hello World. You wake up, but something doesn't feel right. You quickly get out of bed. Where is everyone? You should probably check the time.

Adventure
An Interactive Fiction by Hansen Wu
Release 1 / Serial number 161129 / Inform 7 build 6M62 (I6/v6.33 lib 6/12N) SD

Home
It's gray and dull in here. Bright sunlight pours in through the window.

You can see a watch, a laptop and a charger here.

>examine watch
You can't see any such thing.

>l
Home
It's gray and dull in here. Bright sunlight pours in through the window. You should check the time.

You can see a watch, a laptop and a charger here.

You feel a lack of grasp on the time. Where's your watch?
Your backpack feels unusually light.
Something doesn't feel right.

* * *

>examine watch
You can't see any such thing.

>w
Why would you go to school right now?... Wait, what time is it? You should check your watch first.

You feel a lack of grasp on the time. Where's your watch?
Your backpack feels unusually light.
Something doesn't feel right.

* * *

Hello World. You wake up, but something doesn't feel right. You quickly get out of bed. Where is everyone? You should probably check the time.

Adventure
An Interactive Fiction by Hansen Wu
Release 1 / Serial number 161129 / Inform 7 build 6M62 (I6/v6.33 lib 6/12N) SD

Home
It's gray and dull in here. Bright sunlight pours in through the window.

You can see a watch, a laptop and a charger here.

I beg your pardon?

* * *

Hello World. You wake up, but something doesn't feel right. You quickly get out of bed. Where is everyone? You should probably check the time.

Adventure
An Interactive Fiction by Hansen Wu
Release 1 / Serial number 161129 / Inform 7 build 6M62 (I6/v6.33 lib 6/12N) SD

Home
It's gray and dull in here. Bright sunlight pours in through the window.

You can see a watch, a laptop and a charger here.

>e
You can't go home, there's so much to get done!

You feel a lack of grasp on the time. Where's your watch?
Your backpack feels unusually light.
Something doesn't feel right.

You're in the clubroom

>n
You can't go that way.

You feel a lack of grasp on the time. Where's your watch?
Your backpack feels unusually light.
Something doesn't feel right.

>w
SJSU
You arrive at school, dodging potholes, debris, and terrible drivers on the road. The sun's already up and people are out and about. You lock your bike in the bike cage and quickly head to MacQuarrie Hall. This is SJSU, a college in Silicon Valley with a long history, stuck in the middle of downtown San Jose. You should go to the CS Club and get some work done before class starts.

The staircase leads up to the clubroom on the second floor.

You feel unprepared.

* * *

>e
You can't go home, there's so much to get done!

You feel unprepared.

>s
(first opening the staircase)

Clubroom
This is the CS club room. CS stuff happens here.

The staircase leads to the first floor and the rest of SJSU.

You feel unprepared.

You're in the clubroom

* * *

>e
You can't go home, there's so much to get done!

You feel a lack of grasp on the time. Where's your watch?
Your backpack feels unusually light.
Something doesn't feel right.

You're in the clubroom

>take watch, laptop, charger
watch: Taken.
laptop: Taken.
charger: Taken.

You're in the clubroom

>w
SJSU
You arrive at school, dodging potholes, debris, and terrible drivers on the road. The sun's already up and people are out and about. You lock your bike in the bike cage and quickly head to MacQuarrie Hall. This is SJSU, a college in Silicon Valley with a long history, stuck in the middle of downtown San Jose. You should go to the CS Club and get some work done before class starts.

The staircase leads up to the clubroom on the second floor.

You're in the clubroom

>l
SJSU
SJSU, a college in Silicon Valley with a long history, stuck in the middle of downtown San Jose. You should go to the CS Club and get some work done before class starts.

The staircase leads up to the clubroom on the second floor.

You're in the clubroom

>up
(first opening the staircase)

Clubroom
This is the CS club room. CS stuff happens here.

The staircase leads to the first floor and the rest of SJSU.

* * *

Hello World. You wake up, but something doesn't feel right. You quickly get out of bed. Where is everyone? You should probably check the time.

Adventure
An Interactive Fiction by Hansen Wu
Release 1 / Serial number 161129 / Inform 7 build 6M62 (I6/v6.33 lib 6/12N) SD

Home
It's gray and dull in here. Bright sunlight pours in through the window.

You can see a watch, a laptop and a charger here.

>take watch
Taken.

Your backpack feels unusually light.
Something doesn't feel right.

>examine watch
You check your watch. Oh no, you woke up far too late! Good thing there's still time to get to school. Speaking of which, school is to the west.

Your backpack feels unusually light.
Something doesn't feel right.

>n
You can't go that way.

Your backpack feels unusually light.
Something doesn't feel right.

* * *

Hello World. You wake up, but something doesn't feel right. You quickly get out of bed. Where is everyone? You should probably check the time.

Adventure
An Interactive Fiction by Hansen Wu
Release 1 / Serial number 161129 / Inform 7 build 6M62 (I6/v6.33 lib 6/12N) SD

Home
It's gray and dull in here. Bright sunlight pours in through the window.

You can see a watch, a laptop and a charger here.

>up
You can't go that way.

You feel a lack of grasp on the time. Where's your watch?
Your backpack feels unusually light.
Something doesn't feel right.

>down
You can't go that way.

You feel a lack of grasp on the time. Where's your watch?
Your backpack feels unusually light.
Something doesn't feel right.

>w
SJSU
You arrive at school, dodging potholes, debris, and terrible drivers on the road. The sun's already up and people are out and about. You lock your bike in the bike cage and quickly head to MacQuarrie Hall. This is SJSU, a college in Silicon Valley with a long history, stuck in the middle of downtown San Jose. You should go to the CS Club and get some work done before class starts.

The staircase leads up to the clubroom on the second floor.

You feel unprepared.

>up
(first opening the staircase)

Clubroom
This is the CS club room. CS stuff happens here.

The staircase leads to the first floor and the rest of SJSU.

You feel unprepared.

You're in the clubroom

* * *

Hello World. You wake up, but something doesn't feel right. You quickly get out of bed. Where is everyone? You should probably check the time.

Adventure
An Interactive Fiction by Hansen Wu
Release 1 / Serial number 161129 / Inform 7 build 6M62 (I6/v6.33 lib 6/12N) SD

Home
It's gray and dull in here. Bright sunlight pours in through the window.

You can see a watch, a laptop and a charger here.

>take laptop
Taken.

You feel a lack of grasp on the time. Where's your watch?
Something doesn't feel right.

>drop laptop
Dropped.

You feel a lack of grasp on the time. Where's your watch?
Your backpack feels unusually light.
Something doesn't feel right.

>l
Home
It's gray and dull in here. Bright sunlight pours in through the window.

You can see a laptop, a watch and a charger here.

You feel a lack of grasp on the time. Where's your watch?
Your backpack feels unusually light.
Something doesn't feel right.

* * *

>take laptop
Taken.

You feel a lack of grasp on the time. Where's your watch?
Something doesn't feel right.

>w
SJSU
You arrive at school, dodging potholes, debris, and terrible drivers on the road. The sun's already up and people are out and about. You lock your bike in the bike cage and quickly head to MacQuarrie Hall. This is SJSU, a college in Silicon Valley with a long history, stuck in the middle of downtown San Jose. You should go to the CS Club and get some work done before class starts.

The staircase leads up to the clubroom on the second floor.

You feel unprepared.

>up
(first opening the staircase)

Clubroom
This is the CS club room. CS stuff happens here. Strange, where is everyone? Oh well, put down your laptop and get working!

The staircase leads to the first floor and the rest of SJSU.

You feel unprepared.

* * *

>w
SJSU
You arrive at school, dodging potholes, debris, and terrible drivers on the road. The sun's already up and people are out and about. You lock your bike in the bike cage and quickly head to MacQuarrie Hall. This is SJSU, a college in Silicon Valley with a long history, stuck in the middle of downtown San Jose. You should go to the CS Club and get some work done before class starts.

The staircase leads up to the clubroom on the second floor.

You feel unprepared.

>u
(first opening the staircase)

Clubroom
This is the CS club room. CS stuff happens here. Strange, where is everyone? Oh well, put down your laptop and get working!

The staircase leads to the first floor and the rest of SJSU.

You feel unprepared.

>drop laptop
Dropped.

You feel unprepared.

Alright, let's get cracking! You open up your laptop and get started, going through the boot sequence and typing in passwords.

    *** ... Only to notice that the battery is low, and you forgot your charger at home. A sinking feeling washes over you. Unfortunately you can't get anything done today. ***

Would you like to RESTART, RESTORE a saved game, QUIT or UNDO the last command?

* * *

Hello World. You wake up, but something doesn't feel right. You quickly get out of bed. Where is everyone? You should probably check the time.

Adventure
An Interactive Fiction by Hansen Wu
Release 1 / Serial number 161129 / Inform 7 build 6M62 (I6/v6.33 lib 6/12N) SD

Home
It's gray and dull in here. Bright sunlight pours in through the window.

You can see a watch, a laptop and a charger here.

>e watch
I only understood you as far as wanting to (go) e.

>ex watch
That's not a verb I recognise.

>examine watch
You check your watch. Oh no, you woke up far too late! Good thing there's still time to get to school. Speaking of which, school is to the west.

You feel a lack of grasp on the time. Where's your watch?
Your backpack feels unusually light.
Something doesn't feel right.

* * *

Hello World. You wake up, but something doesn't feel right. You quickly get out of bed. Where is everyone? You should probably check the time.

Adventure
An Interactive Fiction by Hansen Wu
Release 1 / Serial number 161129 / Inform 7 build 6M62 (I6/v6.33 lib 6/12N) SD

Home
It's gray and dull in here. Bright sunlight pours in through the window.

You can see a watch, a laptop and a charger here.

>take charger, laptop
charger: Taken.
laptop: Taken.

You feel a lack of grasp on the time. Where's your watch?

>w
SJSU
You arrive at school, dodging potholes, debris, and terrible drivers on the road. The sun's already up and people are out and about. You lock your bike in the bike cage and quickly head to MacQuarrie Hall. This is SJSU, a college in Silicon Valley with a long history, stuck in the middle of downtown San Jose. You should go to the CS Club and get some work done before class starts.

The staircase leads up to the clubroom on the second floor.

* * *

>u
(first opening the staircase)

Clubroom
This is the CS club room. CS stuff happens here. Strange, where is everyone?

The staircase leads to the first floor and the rest of SJSU.

>drop laptop
Dropped.

You feel unprepared.

Alright, let's get cracking! You open up your laptop and get started, going through the boot sequence and typing in passwords.
something
Cyber Room
The cyber happens here.

You can see Cyber Button here.

* * *

Hello World. You wake up, but something doesn't feel right. You quickly get out of bed. Where is everyone? You should probably check the time.

Adventure
An Interactive Fiction by Hansen Wu
Release 1 / Serial number 161129 / Inform 7 build 6M62 (I6/v6.33 lib 6/12N) SD

Home
It's gray and dull in here. Bright sunlight pours in through the window.

You can see a watch, a laptop and a charger here.

>pess
That's not a verb I recognise.

>press
What do you want to press?

>press laptop
Nothing obvious happens.

You feel a lack of grasp on the time. Where's your watch?
Your backpack feels unusually light.
Something doesn't feel right.

* * *

Hello World. You wake up, but something doesn't feel right. You quickly get out of bed. Where is everyone? You should probably check the time.

Adventure
An Interactive Fiction by Hansen Wu
Release 1 / Serial number 161129 / Inform 7 build 6M62 (I6/v6.33 lib 6/12N) SD

Home
It's gray and dull in here. Bright sunlight pours in through the window.

You can see a watch, a laptop and a charger here.

>press on laptop
You can't see any such thing.

>press laptop
Nothing obvious happens.

You feel a lack of grasp on the time. Where's your watch?
Your backpack feels unusually light.
Something doesn't feel right.

* * *

Hello World. You wake up, but something doesn't feel right. You quickly get out of bed. Where is everyone? You should probably check the time.

Adventure
An Interactive Fiction by Hansen Wu
Release 1 / Serial number 161129 / Inform 7 build 6M62 (I6/v6.33 lib 6/12N) SD

Home
It's gray and dull in here. Bright sunlight pours in through the window.

You can see a watch, a laptop and a charger here.

>take laptop and charger
laptop: Taken.
charger: Taken.

You feel a lack of grasp on the time. Where's your watch?

>where is charger
That's not a verb I recognise.

>locate
That's not a verb I recognise.

>examine laptop and charger
You can't use multiple objects with that verb.

>examine laptop
Your laptop is lying around. Ten pounds of Linux! This is where the Cyber happens. 

You feel a lack of grasp on the time. Where's your watch?

* * *

>take laptop and charger
laptop: Taken.
charger: Taken.

You feel a lack of grasp on the time. Where's your watch?

>examine watch
You check your watch. Oh no, you woke up far too late! Good thing there's still time to get to school. Speaking of which, school is to the west.

You feel a lack of grasp on the time. Where's your watch?

>take watch
Taken.

>w
SJSU
You arrive at school, dodging potholes, debris, and terrible drivers on the road. The sun's already up and people are out and about. You lock your bike in the bike cage and quickly head to MacQuarrie Hall. This is SJSU, a college in Silicon Valley with a long history, stuck in the middle of downtown San Jose. You should go to the CS Club and get some work done before class starts.

The staircase leads up to the clubroom on the second floor.

* * *

>u
(first opening the staircase)

Clubroom
This is the CS club room. CS stuff happens here. Strange, where is everyone?

The staircase leads to the first floor and the rest of SJSU.

>look
Clubroom
This is the CS club room. CS stuff happens here. Strange, where is everyone?

The staircase leads to the first floor and the rest of SJSU.

* * *

Hello World. You wake up, but something doesn't feel right. You quickly get out of bed. Where is everyone? You should probably check the time.

Adventure
An Interactive Fiction by Hansen Wu
Release 1 / Serial number 161129 / Inform 7 build 6M62 (I6/v6.33 lib 6/12N) SD

Home
It's gray and dull in here. Bright sunlight pours in through the window.

You can see a watch, a laptop and a charger here.

>take laptop, charger, watch
laptop: Taken.
charger: Taken.
watch: Taken.

>take all
There are none at all available!

* * *

Hello World. You wake up, but something doesn't feel right. You quickly get out of bed. Where is everyone? You should probably check the time.

Adventure
An Interactive Fiction by Hansen Wu
Release 1 / Serial number 161129 / Inform 7 build 6M62 (I6/v6.33 lib 6/12N) SD

Home
It's gray and dull in here. Bright sunlight pours in through the window.

You can see a watch, a laptop and a charger here.

>take all
watch: Taken.
laptop: Taken.
charger: Taken.

>w
SJSU
You arrive at school, dodging potholes, debris, and terrible drivers on the road. The sun's already up and people are out and about. You lock your bike in the bike cage and quickly head to MacQuarrie Hall. This is SJSU, a college in Silicon Valley with a long history, stuck in the middle of downtown San Jose. You should go to the CS Club and get some work done before class starts.

The staircase leads up to the clubroom on the second floor.

>u
(first opening the staircase)

Clubroom
This is the CS club room. CS stuff happens here. You should take out your laptop and get working. Strange, where is everyone?

The staircase leads to the first floor and the rest of SJSU.

>look
Clubroom
This is the CS club room. CS stuff happens here. You should take out your laptop and get working. 

The staircase leads to the first floor and the rest of SJSU.

>drop laptop
Dropped.

You feel unprepared.

Alright, let's get cracking! You open up your laptop and get started, going through the boot sequence and typing in passwords.
You plug in your laptop to charge it up. But what's this? The clubroom's door slams shut, and metal shielding covers the windows. The room goes dark, sirens blare, and red lights flash. You're in the cyber Room!

Cyber Room
The room is dark, there's flashing lights, and electronic music is playing. Is this Def Con? A sign above the door says "Cyber Room". Evidently, the cyber happens here. Your laptop screen flashes the text "SHALL WE PLAY A GAME" before disappearing, and a big red security button appears beside you.

You can see Security Button here.

* * *

>u
(first opening the staircase)

Clubroom
This is the CS club room. CS stuff happens here. You should take out your laptop and get working. Strange, where is everyone?

The staircase leads to the first floor and the rest of SJSU.

>l
Clubroom
This is the CS club room. CS stuff happens here. You should take out your laptop and get working. 

The staircase leads to the first floor and the rest of SJSU.

>drop laptop
Dropped.

Alright, let's get cracking! You open up your laptop and get started, going through the boot sequence and typing in passwords.
You plug in your laptop to charge it up. But what's this? The clubroom's door slams shut, and metal shielding covers the windows. The room goes dark, sirens blare, and red lights flash. You're in the cyber Room! Your laptop screen flashes the text "SHALL WE PLAY A GAME" before disappearing, and a big red security button appears beside you.

Cyber Room
The room is dark, there's flashing lights, and electronic music is playing. Is this Def Con? A sign above the door says "Cyber Room". Evidently, the Cyber™ happens here.

You can see Security Button here.

>l
Cyber Room
The room is dark, there's flashing lights, and electronic music is playing. Is this Def Con? A sign above the door says "Cyber Room". Evidently, the Cyber™ happens here.

You can see a laptop and Security Button here.

>examine security button
Big, red, with block letters saying "SECURITY" on it. Push for security to happen. Or Cyber™. Something like that, pick the buzzword of your choice.

>examine laptop
Ten pounds of Linux! This is where the Cyber™ happens.  A few terminal windows are tiled to the screen corners, with green text flows across them. Since when did you use green text? Something tells you that Cyber™ is happening.

>press button
    *** You push the button and ... nothing happens. "They're in the kernel!" a voice shouts, and you find yourself jolted awake in class. Huh, you weren't in a Cyber Room, you just fell asleep in class ***

Would you like to RESTART, RESTORE a saved game, QUIT or UNDO the last command?

* * *

>u
(first opening the staircase)

Clubroom
This is the CS club room. CS stuff happens here. You should take out your laptop and get working. Strange, where is everyone?

The staircase leads to the first floor and the rest of SJSU.

>drop laptop
Dropped.

Alright, let's get cracking! You open up your laptop and get started, going through the boot sequence and typing in passwords.
You plug in your laptop to charge it up. But what's this? The clubroom's door slams shut, and metal shielding covers the windows. The room goes dark, sirens blare, and red lights flash. You're in the cyber Room! Your laptop screen flashes the text "SHALL WE PLAY A GAME" before disappearing, and a big red security button appears beside you.

Cyber Room
The room is dark, there's flashing lights, and electronic music is playing. Is this Def Con? A sign above the door says "Cyber Room". Evidently, the Cyber™ happens here.

Robot Fox yaps mechanically.

You can also see a laptop and Security Button here.

>l
Cyber Room
The room is dark, there's flashing lights, and electronic music is playing. Is this Def Con? A sign above the door says "Cyber Room". Evidently, the Cyber™ happens here.

Robot Fox yaps mechanically.

You can also see a laptop and Security Button here.

>l robot
Robot Fox, a 100% non-organic silver fox with blue fur accents. It looks cute, although it'll probably shred your Planet Express uniforms. It stares back at you quizzically, and tilts its head.

* * *

>w
SJSU
You arrive at school, dodging potholes, debris, and terrible drivers on the road. The sun's already up and people are out and about. You lock your bike in the bike cage and quickly head to MacQuarrie Hall. This is SJSU, a college in Silicon Valley with a long history, stuck in the middle of downtown San Jose. You should go to the CS Club and get some work done before class starts.

The staircase leads up to the clubroom on the second floor.

>examine watch
You're far behind schedule, better get moving!

>examine laptop
Ten pounds of Linux! This is where the Cyber happens.

>look
SJSU
SJSU, a college in Silicon Valley with a long history, stuck in the middle of downtown San Jose. You should go to the CS Club and get some work done before class starts.

The staircase leads up to the clubroom on the second floor.

>take staircase
That's fixed in place.

>up
(first opening the staircase)

Clubroom
This is the CS club room. CS stuff happens here. You should take out your laptop and get working. Strange, where is everyone?

The staircase leads to the first floor and the rest of SJSU.

>drop laptop
Dropped.

Alright, let's get cracking! You open up your laptop and get started, going through the boot sequence and typing in passwords.
You plug in your laptop to charge it up. But what's this? The clubroom's door slams shut, and metal shielding covers the windows. The room goes dark, sirens blare, and red lights flash. You're in the cyber Room!

Cyber Room
The room is dark, there's flashing lights, and electronic music is playing. Is this Def Con? A sign above the door says "Cyber Room". Evidently, the cyber happens here. Your laptop screen flashes the text "SHALL WE PLAY A GAME" before disappearing, and a big red security button appears beside you.

You can see Security Button here.

>l
Cyber Room
The room is dark, there's flashing lights, and electronic music is playing. Is this Def Con? A sign above the door says "Cyber Room". Evidently, the cyber happens here.

You can see a laptop and Security Button here.

>examine laptop
Ten pounds of Linux! This is where the Cyber happens.  A few terminal windows are tiled to the screen corners, and Green text flows across them. Since when did you use green text? Something tells you that Cyber is happening.

* * *

>w
SJSU
You arrive at school, dodging potholes, debris, and terrible drivers on the road. The sun's already up and people are out and about. You lock your bike in the bike cage and quickly head to MacQuarrie Hall. This is SJSU, a college in Silicon Valley with a long history, stuck in the middle of downtown San Jose. You should go to the CS Club and get some work done before class starts.

The staircase leads up to the clubroom on the second floor.

I beg your pardon?

>u
(first opening the staircase)

Clubroom
This is the CS club room. CS stuff happens here. You should take out your laptop and get working. Strange, where is everyone?

The staircase leads to the first floor and the rest of SJSU.

* * *

>l
Cyber Room
The room is dark, there's flashing lights, and electronic music is playing. Is this Def Con? A sign above the door says "Cyber Room". Evidently, the Cyber™ happens here.

Robot Fox yaps mechanically.

You can also see a laptop and Security Button here.

>examine fox
Robot Fox, a 100% non-organic silver fox with blue fur accents. It looks cute, although it'll probably shred your Planet Express uniforms.

>examine robot
Robot Fox, a 100% non-organic silver fox with blue fur accents. It looks cute, although it'll probably shred your Planet Express uniforms.

>examine
What do you want to examine?

>examine laptop
Ten pounds of Linux! This is where the Cyber™ happens.  A few terminal windows are tiled to the screen corners, with green text flows across them. Since when did you use green text? Something tells you that Cyber™ is happening.

>take fox\t
You can't see any such thing.

>l
Cyber Room
The room is dark, there's flashing lights, and electronic music is playing. Is this Def Con? A sign above the door says "Cyber Room". Evidently, the Cyber™ happens here.

Robot Fox yaps mechanically.

You can also see a laptop and Security Button here.

>take robot fox
I don't suppose Robot Fox would care for that.

>pet
That's not a verb I recognise.

>push robot fox
Robot Fox might not like that.

>eat
What do you want to eat?

>eat robot fox
He's plainly inedible.

* * *

Hello World. You wake up, but something doesn't feel right. You quickly get out of bed. Where is everyone? You should probably check the time.

Adventure
An Interactive Fiction by Hansen Wu
Release 1 / Serial number 161129 / Inform 7 build 6M62 (I6/v6.33 lib 6/12N) SD

Home
It's gray and dull in here. Bright sunlight pours in through the window.

You can see a watch, a laptop and a charger here.

>push laptop w
The laptop cannot be pushed from place to place.

You feel a lack of grasp on the time. Where's your watch?
Your backpack feels unusually light.
Something doesn't feel right.

>push laptop west
The laptop cannot be pushed from place to place.

You feel a lack of grasp on the time. Where's your watch?
Your backpack feels unusually light.
Something doesn't feel right.

>break
What do you want to break?

>hit
What do you want to hit?

>hit laptop
Violence isn't the answer to this one.

You feel a lack of grasp on the time. Where's your watch?
Your backpack feels unusually light.
Something doesn't feel right.

>w
SJSU
You arrive at school, dodging potholes, debris, and terrible drivers on the road. The sun's already up and people are out and about. You lock your bike in the bike cage and quickly head to MacQuarrie Hall. This is SJSU, a college in Silicon Valley with a long history, stuck in the middle of downtown San Jose. You should go to the CS Club and get some work done before class starts.

The staircase leads up to the clubroom on the second floor.

You feel unprepared.